1000000000000000000000000000000000000000000000000000000000000000000001
1000000000000000000000000000000000000000000000000000000000000000000001
1000000000000000000000000000000000000000000000000000000000000000000001
1000000000000000000000000000000000000000000000000000000000000000000001
1100000000000000000000000000000000000000000000000000000000000000000001
1000000000000000000000000000000000000000000000000000000000000000000001
1000000000000000000000000000000000000000000000000000000000000000000001
1!)(з00000000000000000000000000000000000000000000000000000000000000001
1%#$000000000000000000000000000000000000000000000000000000000000000001
1000000000000000000000000000000000000000000000000000000000000011111111
1000000000000000000000000000000000000000000000000001111111000000000001
10002j4jk5000024444500;00111100;00;00;00;00000000000000000000000000001
1000qыыыыw>>>>qыыыыw00000000000000000000000000000000000000000000000001
100000000000000000000000000000000000000000000000;00<<<<<<<;00;2444в251
1000000000000000000000000000000000000;002jjk45000000000000000038880361
2!)(500;;;;;;;;000002500;24j500;00;000003888860000000000000000qыыы0qw1
38886000000000000002э6000388600000000000388886000000000000000000000001
3888600000000000002э86000388j00000000000388886000000000000000000000001
388874444444445002э886000388600000000000388886000000000000000000000001
3888888888888889938886999388699999999999388886999999999999999999999991