1233333333333333333333333333341
5000000000000700000000007000005
6000000000000700000000007007006
600000000000@700077777007007006
6007777777777770070007007007006
6000000000000000000000000007006
6000000000000000000000000007006
6000007007777777777007777777006
6000007007000000000007000000006
6007777007000000000007000000006
6007000000007777777007007777006
6007000000000000000000007000006
6007007777000000000000007000006
6000007007007770077007007700776
6000007000000000007007000000006
6007007000000000007007000000006
6007777007770077777007700777776
6000000000000000000000000000006
8000000000000000000000000000008
1233333333333333333333333333341